#########
#E.....F#
#..#.##.#
#.#.....#
#...##..#
#.#.#..##
#.#..#..#
#M....#.#
#########